NO ./path_to_the_north_texture
SO ./path_to_the_south_texture
WE ./path_to_the_west_texture
EA ./path_to_the_east_texture


F 220,100,250
C 250,30,0





111111111111111111
100010100000010011
101101001000010001
100100000110101111
111110000000000001
100010101000000W01
111110010100000001
111111111111111111
