NO ./path_to_the_north_texture
SO ./path_to_the_south_texture
WE ./path_to_the_west_texture
EA ./path_to_the_east_texture


F 220,100,250
C 250,30,0




1111111111111111111111111
1000000000110100000000001
1011000001110000000000011
1001000000000000000000001
1111111110110000011100001
10000000001100E0011101111
1111011111111101110000001
1111011111111101110101001
1100000011010101110000001
1000000000000000110000001
1000000000000000110101001
1100000111010101111101111
11110111 1110101 10111101
1111111111111111111111111
