NO ./path_to_the_north_texture
SO ./path_to_the_south_texture
WE ./path_to_the_west_texture
EA ./path_to_the_east_texture


F 220,100,250
C 250,30,0




1111111111111111111111111111111111
100000000011010000000000000000N001
1011000001110000000000011000000001
1001000000000000000000001111111111
1111111110110000011100001
1000000000110000011101111
1111011111110100010000001
1111011111111101110101001
1100000011010101110000001
10000000000000001100000011111111
10000000000000001101010011111111
1100000111010101111101101
11110111 1110101 10101011
1111111111111111111111111