NO ./path_to_the_north_texture
SO ./path_to_the_south_texture
WE ./path_to_the_west_texture
EA ./path_to_the_east_texture


F 220,100,250
C 250,30,0



111111111111111111
1000111000N0010011
101100001100000001
100100000111111111
111110000000000001
100010111000000001
111110000000000001
111111111111111111
