NO     ./textures/no.xpm


SO       ./textures/so.xpm




WE    ./textures/we.xpm



EA ./textures/skull.xpm


F 40,54,24
C 4,159,214



        1111111111111111111111111
        1000000000000000000000001
        101100000001000000100001
        10010000000R0000000000001
11111111101100000111000000W00001


100000000011000001110111111111111
11110111111111010000000000001
11110111111111011101010010001
11000000110101011100000010001
10000000000000001100000010001
10000000000000001101010010001
110000111010101111101111000111
11110111 1110101 101111010001
11111111 1111111 1111111111111
