NO     ./textures/no.xpm


SO       ./textures/so.xpm




WE    ./textures/we.xpm



EA     ./textures/skull.xpm


C 21,     7,84
F 73,55,60



        1111111111111111111111111
        1000000000000000001100001
        1011000000010000000000011
        10110000000100000000000101
        10010000000000000000000001
11111111101100000111000000W0000101
10000000001100000111R111110111111
11110111111111010000000000001
11110111111111011101010010001
11000000110101011100000010001
10000000000000001100000010001
10000000000000001101010010001
110000111010101111101111000111
11110111 1110101 101111010001
11111111 1111111 1111111111111
